NO textures/wall_1.xpm
SO textures/wall_2.xpm
EA textures/wall_5.xpm
WE textures/wall_3.xpm
F 184,113,75
C 211,198,222


         111111111  111111111111111111
         100000001  100000000000000001
         10110000111100000001111111111
11111111110000000000100000011111
100000001111000100010000N1001
100000001  100110101110000001
10000000111110000001 10100001
11111111111111111111 11111111
     
1111 111111111111111111111111
1111 1000000         00000001
1111 111111111111111111111111