NO textures/greenlight.xpm
SO textures/bluestone.xpm
EA textures/redbrick.xpm
WE textures/eagle.xpm
F 245,244,249
C 105,66,222
111111111111111111111111
100000000000000000000001
100000000000000000000001
100000000000000000000001
100000111110000000000001
100000100010000000000001
100000100010000000000001
100000100010000000000001
100000110110000000000001
100000000000000000000001
100000000000000000000001
10000000000N000000000001
100000000000000000000001
100000000000000000000001
1111111110000000000000001
100000001000000000000001
100010001000000000000001
10000001000000000000001
10000001000000000000001
100000001000000000000001
111111111000000000000001
110000000000000000000001
111111111000000000000001
111111111111111111111111