NO textures/wood.xpm
SO textures/bluestone.xpm
EA textures/colorstone.xpm
WE textures/eagle.xpm
F 184,113,75
C 211,198,222

11111111111111111111111
10000000000000000000001
101010101000S00000011111
10001010001000010001
111110101111101011101
100000101000101000001
101111101011101111111
101000001010100000101
101011111010111110101
101010001010100010101
101110101010101010101
100000101010001010001
111111101011111011101
100000101000100010001
101110101110101110111
101000100000100010101
101011111111111010101
100010000000000010001
1010101110111111111101
1111111111111111111111
