NO ./path_to_the_north_texture
SO ./path_to_the_south_texture
WE ./path_to_the_west_texture
EA ./path_to_the_east_texture

F 184,113,75
C 211,198,222

1111111111111111111
1001001001111101111
1000000000000001001
1000000000000001001
1000000000000001001
1001111000001001001
10000000N0000001001
1001111111111001001
1111000000000001011
1000000001000000001
1111111111111111111