NO ./path_to_the_north_texture
SO ./path_to_the_south_texture
WE ./path_to_the_west_texture
EA ./path_to_the_east_texture
F 220,100,0
C 225,30,0


1111111111111111111111111
1000000000110000000000001
1011000001110000000000001
1001000000000000000000001
11111111101100000111000011
10000000101100000111011110
11110111111111011100000010001
11111111111111011101010010001
11000000110101011100000010001
1000000001        1111   0001
111111001
1000000
11110111011101010101111010001
11111111011111110111111111111
