NO textures/barrel.xpm
SO textures/bluestone.xpm
EA textures/colorstone.xpm
WE textures/eagle.xpm

F 184,113,75
C 211,198,222

1111111111111111111111111
1000000000000000000000001
N1010101010111111100011111
100010100010000010001
111110101111101011101
100000101000101000001
101111101011101111111
101000001010100000101
101011111010111110101
101010001010100010101
101110101010101010101
100000101010001010001
111111101011111011101
100000101000100010001
101110101110101110111
101000100000100010101
101011111111111010101
100010000000000010001
1010101110111111111101
100000000000000000001
111111111111111111111