NO textures/barrel.xpm
SO textures/bluestone.xpm
EA textures/colorstone.xpm
WE textures/eagle.xpm
F 220,100,0
C 225,30,0


1111111111111111111111111
1000000000110000000000001
1011000001110000000000001
10010000000000W0000000001
11111111101100000111000011
10000000N01100N00111011110
1111011111111101110000S010001
11111111111111011101010010001
11000000110101011100000010001
1000000001        1111   0001
111111001
1000000
11110111011101010101111010001
11111111011111110111111111111
